####################
#                  #
#e         e       #
###                #
#                  #
#               e  #
#                  #
#        ########  #
#        ##        #
#        #         #
#        #         #
# p      #   e     #
#        #         #
####################
