#########d##########
#                  #
#e                 #
###                #
#                  #
#                  #
#                  #
#         #######  #
#        ##        #
#        #         #
#        #         #
# p      #         #
#        #         #
####################
