####################
#                  #
# B  1         B   #
#            1    ##
#####        ##### #
#                  #
#                  #
# p            1   #
#                  #
#      #           #
#      #      #### #
#     ##         # #
#  ####          ###
####################
